████████████████████████████████████████████████████████
█                                                      █
█                                              V       █
█                                             /8\      █
█                                              │       █
█                                                      █
█                                                      █
█                                                      █
█                                                      █
█                                                      █
█                                                      █
█                                                      █
█                                                      █
█                                                      █
█                                                      █
█                                                      █
█                                                      █
█                                                      █
█                                                      █
█                                                      █
█                                                      █
█          ┌─────────┐                                 █
█          ├─────────┤                                 █
█          │         │                                 █
█                                                      █
█                                                      █
█                                                      █
████████████████████████████████████████████████████████